EA ./textures/player.xpm
NO ./textures/player.xpm
WE ./textures/player.xpm
SO ./textures/player.xpm


F   100, 15, 46




C	 0, 50,2

1111111111111111111111111111111111111111111
10000000000000000111000110001 10000000000000111
10000000000000000000000000011100000000111111
1000001110000000000000000000000000000111
10000010000000000000010000000000000001
10000000000001000000000100000000000011
1000011000001 10000000000000000000000011
10000000000001000000000000000000000111111
10000000000111000001000000000100000000001
100000001111 10000000000000000000000N111
111111111111111111111111111111111111111